NO ./sprites/tree_nord.png
SO ./sprites/tree_south.png
WE ./sprites/tree_west.png
EA ./sprites/tree_east.png

F 220,100,0
C 70,130,180

111111
100001
10E001
100001
011111
