NO ./sprites/tree_nord.png
SO ./sprites/tree_south.png
WE ./sprites/tree_west.png
EA ./sprites/tree_east.png

F 100,60,30
C 20,20,40

        1111111              1111
      11100000111    		110011
     1100000000011           1111
    110010010010011
    100000000000001
    1001000E0001001
    100011100000001
    11001 10010011
     1101110000011
      11100000111
        1111111
