NO ./sprites/tree_nord.png
SO ./sprites/tree_south.png
WE ./sprites/tree_west.png
EA ./sprites/tree_east.png

F 100,60,30
C 20,20,40

        1111111
      11100000111
     1100000000011
    110010010010011
    100000000000001
    1001000E0001001
    100000000000001
    110010010010011
     1100000000011
      11100000111
        1111111
