NO ./sprites/tree_nord.png
SO ./sprites/tree_south.png
WE ./sprites/tree_west.png
EA ./sprites/tree_east.png

F 20,20,20
C 200,200,200

1111111111111111111111111111111111
1000000000000000000000000000000001
1000000000000000000000000000000001
1W00000000000000000000000000000001
1000000000000000000000000000000001
1000000000000000000000000000000001
1111111111111111111111111111111111
