NO    ./sprites/tree_nord.png

      F    255,0,0
SO ./sprites/tree_south.png

    C  0,255,0


WE      ./sprites/tree_west.png

  EA ./sprites/tree_east.png


111111111111
100000000001
10000N000001
111111111111
