NO ./sprites/tree_nord.png
SO ./sprites/tree_south.png
WE ./sprites/tree_west.png
EA ./sprites/tree_east.png

F 50,50,50
C 135,206,235

111111111111111
100000000000001
101111111111101
101000000000101
101011111110101
101010000010101
1010101W1010101
101010101010101
101011101110101
101000000000101
101111111111101
100000000000001
111111111111111
